%%%%%%%%%%%%%%%%%%%%%%%%%%%%%%%%%%%%%%%%%%%%%%%%%%
%1              %%.%%.%%  %%.%%.%%              4%
% %%  %% %%%%%% ..o..        ..o.. %%%%%% %%  %% %
% %%  %% %%%%%. %%.%% %%     %%.%% .%%%%% %%  %% %
%        %%%%%. %%.%% %%  %% %%.%% .%%%%%        %
% %%%%%% %%%%%. .. ..     %% .. .. .%%%%% %%%%%% %
% .....% %%%%%% %%.%%        %%.%% %%%%%% %..... %
% .....%        %%.%% %%  %% %%.%%        %..... %
% .....%        .. ..        .. ..        %..... %
% .....%        %%.%% %%  %% %%.%%        %..... %
% .....% %%%%%% %%.%%        %%.%% %%%%%% %..... %
% %%%%%% %%%%%. .. .. %%     .. .. .%%%%% %%%%%% %
%        %%%%%. %%.%% %%  %% %%.%% .%%%%%        %
% %%  %% %%%%%. %%.%%     %% %%.%% .%%%%% %%  %% %
% %%  %% %%%%%% ..o..        ..o.. %%%%%% %%  %% %
%3              %%.%%.%%  %%.%%.%%              2%
%%%%%%%%%%%%%%%%%%%%%%%%%%%%%%%%%%%%%%%%%%%%%%%%%%
